+++++++++++ +++
+  H +++     ++
   +    +++   
+  +  F ++   ++
+           +++
+      +++    +
++++ +  ++ F+ +